#################################################### #########################  
#......................@...........................# #.......................#  
#..................................................# #.......................#  
#..................................................# #.......................#  
#..................................................# #.......................#  
#..................................................# #.......................#  
#..................................................# #.......................#  
#..................................................# #.......................#  
##########=######################################### #.......................#  
         #.#                                         #.......................#  
         #X#        ##################################.......................###
         #.#        #................................#.......................=.#
         #.#        #.##############################.#.......................#.#
         #.#        #.##############################.#.......................#.#
         #.#        #................................=.......................#.#
         #.#        #.##############################.#.......................#.#
         #.#        #.#                            #.#.......................#.#
         #.#        #.#                            #.#.......................#.#
         #.##########.#                            #.#.......................#.#
         #............#                            #.#.......................#.#
#####################.#                            #.#.......................#.#
#...................#.#                            #.#.......................#.#
#...................#.#                            #.#.......................#.#
#...................#.#                            #.#.......................#.#
#...................#.#                            #.#.......................#.#
#...................#.#                            #.#.......................#.#
#........@..........#.#                            #.#.......................#.#
###=#################.############################ #.#.......................#.#
  #..............................................# #.#.......................#.#
#########=######################################.# #.#.......................#.#
#..............................................#.# #.#.......................#.#
#..............................................#.# #.#.......................#.#
#..............................................#.# #.#..................@....#.#
#..............................................#.# #.#########################.#
#..............................................#.###...........................#
#..............................................#...........................###=#
#..............................................#...........................=...#
#......................................@.......#.###########################...#
#..............................................#...........................=..@#
################################################################################
