######    ############################################### ######################
#.@=.#    #.............................................# #....................#
#..#.#  ###.............................................# #....................#
##=#.#  #.=.............................................# #....................#
 #.#.#  #.#.............................................# #....................#
 #.#.#  #.#..................................X..........# #....................#
 #.#.####.###############=###############=############### #....................#
 #........................#             #.#               #....................#
 #.#.####..##############.#             #.#               #....................#
 #.#.#  #..#            #.#             #.#               #....................#
 #.#.####..#            #.#             #.#               #....................#
 #.....##..#            #.#             #.#               #....................#
###=##.##..#            #.#             #.#               #....................#
#....#.##..##############.############# #.#               #....................#
#....#.##.............................# #.#               #....................#
#....=.##.#.#########################.# #.#               #....................#
#....#.##.#.#.......................#.# #.#               #....................#
#....#.##.#.#....@..................#.# #.#               #....................#
#....#.##.#.#.......................#.# #.#               #....................#
#....#.##.#.#.......................#.###.#################....................#
#....#.##.#.#.......................#.....................=....................#
#....#.##.#.#.......................#.#####################....................#
#....#.##...#.......................=.#                   #....................#
#...@#.######.......................#.#                   #....................#
##=###.#    #.......................=.#                   #....................#
 #.....#    #.......................###                   #....................#
 #######    #.......................#                     #....................#
            #.......................#                     #....................#
            #.......................#                     #....................#
            #.......................#                     #....................#
            #.......................#                     #....................#
            #.......................#                     #....................#
            #.......................#                     #....................#
            #.......................#                     #....................#
            #.......................#                     #....................#
            #.......................#                     #....................#
            #.......................#                     #....................#
            #.......................#                     #..................@.#
            #.......................#                     #....................#
            #########################                     ######################
