#######################      ##############################                     
#.....................#      #............................#                     
#.....................#      #............................#                     
#.....................#      #............................#                     
#.....................###    #............................#                     
#.....................=.#    #............................#                     
#.....................#.#    #............................#                     
#.....................#.#    #.................@..........#                     
#.....................#.#    #............................#                     
#.....................=.###############################=###                     
#.........@...........#.#...............................#                       
#.....................#.#.#############################.#########               
#.....................#.#.###########################...........#               
#.....................#...............................#########=################
#.....................#.#.#############################........................#
#.....................#.#.#                           #........................#
#########=#############.#.#         #####             #........................#
        #.#       #.......#         #...#             #........................#
        #.#       #.#####=###########=#.#             #........................#
        #.#       #.#.................#.#             #........................#
        #.#       #.#............@....#.#             #.....@..................#
        #.#       #.#.................#.#             #........................#
        #.#       #.#.................#.#             #........................#
        #.#       #.#.................#.#             #........................#
        #.#       #.#...X.............#.#             #........................#
        #.#       #.#.................#.#             #........................#
        #.#       #.#.................#.#             #........................#
        #.#       #.#.................#.#             #........................#
        #.#       #.#####=#############.#             #........................#
        #.#       #.......#           #.#             #........................#
        #.#####   ###.#####           #.#######       #........................#
        #.....#     #.#               #.......#       #........................#
#############=#######=#######################=######  #........................#
#..................................................#  #........................#
#..................................................#  #........................#
#..................................................#  #........................#
#..................................................#  #........................#
#..................................................#  #........................#
#.......................................@..........#  #........................#
####################################################  ##########################
