######          ###################                   ##########################
#....#          #.................#                   #........................#
#....#          #.................#                   #........................#
#....#          #.................#                   #........................#
#....#          #.................#                   #........................#
#.@..############.................#                   #........................#
#....#.........##@................#                   #........................#
#....#.#######.##.................#                   #........................#
#....#.#.....#.##.................#                   #........................#
#....#.#.....#.##.................#                   #........................#
#....#.#.....#.##.................#                   #........................#
#....#.#.....#.##.................#                   #........................#
#....#.#.....#.##.................#                   #........................#
#....#.#.....#.##.................#                   #........................#
#....#.=.....#.##.................#                   #........................#
#....#.#.....#.##.................#                   #........................#
#....#.#.....#.##.................#                   #..........@.............#
#....#.#.....#.##.................#                   #........................#
#....#.#.....#..#########=#########                   #........................#
#....#.#.....#............#                           #........................#
#....#.#.....#.##########.#                           #........................#
#....#.#.....#.#        #.#                           #........................#
#....#.#...@.#.#        #.#                           #........................#
#....#.#.....#.##########.#############################........................#
#....#.#.....#........................................######=###############=###
#....#.#.....#...............................................................#  
#....#.#.....############.#############################.######################  
#....#.#.....#          #.#...........................#.#                       
#....#.=.....#          #.#...........................#.#                       
#....#.#.....#          #.#..........X................#.#                       
#....#.#.....#          #.#...........................#.#                       
#....=.#.....###        #.#...........................#.#                       
#....###.....=.#        #.#...........................#.#                       
#....# #.....#.#        #.#...........................#.#                       
#....# #.....#.#        #.#...........................#.#                       
#....# #.....#.#        #.#...........................#.#                       
#....# #.....#.##########.#.................@.........#.#                       
#....# #.....#............#...........................=.#                       
#....# #.....##############...........................###                       
###### #######            #############################                         
