##################              ################################################
#................#              #..............................................#
#..........@.....#              #..............................................#
#................#              #..............................................#
#................#              #..............................................#
#................#              #..............................................#
#................#              #.....................................@........#
#................#              #..............................................#
#................#              #...............X..............................#
#................#              #..............................................#
#................#              #..............................................#
#................#              #..............................................#
#................#              #..............................................#
#................#              #..............................................#
#................################..............................................#
#................=..............####=#############################=#=###########
#................#...................................................#          
####=###########=#.#################.##################.########################
  #.....................................................=......................#
  #.############.#..################.##################.#......................#
  #.#          #.#..#              #.#                #.#.............@........#
  #.#          #.#..#              #.#                #.#......................#
  #.############.#..############## #.#                #.#......................#
  #..............................###.##################.#......................#
###=###############=############........................=......................#
#..............................#.###.##################.#......................#
#..............................#.# #.#                #.#......................#
#..............................#.# #.#                #.#......................#
#..............................#.# #.#                #.#......................#
#..............................#.# #.#                #.#......................#
#..............................#.# #.#                #.#......................#
#..............................#.# #.#                #.#......................#
#.......................@......#.# #.#                #.#......................#
################################.# #.#                #.#......................#
                               #.###.####             #.#......................#
                               #........#             #.#......................#
#######################################.#             #.#......................#
#....................@................=.###############.#......................#
#.....................................#.................=......................#
################################################################################
