<?xml version="1.0" encoding="UTF-8" standalone="no" ?>
<engine_level_t xmlns="urn:rpg" xmlns:xsi="http://www.w3.org/2001/XMLSchema-instance" xsi:schemaLocation="urn:rpg rpg_engine.xsd">

  <name>default level</name>

  <environment outdoors="true">
    <plane>PLANE_MATERIAL</plane>
    <terrain>TERRAIN_UNDER_GROUND</terrain>
    <climate>CLIMATE_TEMPERATE</climate>
    <lighting>AMBIENCE_DARKNESS</lighting>
  </environment>

  <monster>Bugbear</monster>

  <spawn_interval>
    <seconds>10</seconds>
  </spawn_interval>

  <spawn_probability>0.3</spawn_probability>

  <max_spawned>20</max_spawned>

  <amble_probability>0.5</amble_probability>

  <map>##################   ##########################          #######################
#................#   #........................#          #.....................#
#................#   #........................#          #.....................#
#................#   #........................#          #.....................#
#..............@.#   #........................#          #.....................#
#................#   #........................#          #.....................#
#................#   #@.......................#          #.....................#
####=###=#########   #........................############.....................#
   #.# #.#############........................#..........=.....................#
   #.# #.............=........................#.##########....X................#
   #.# #.###########.#........................#.#        #.....................#
   #.# #.#         #.#........................#.#        #.....................#
   #.# #.#         #.#........................#.#        #.....................#
   #.###.#         #.#........................#.##########.....................#
   #.....#         #.#........................#..........=.....................#
#######..###########.#........................#.##########.....................#
#.....#..............##################=#######.#        #.....................#
#.....#.........................................#        #.....................#
#.....#..###############=#.######################        #.....................#
#.....#..#..@............#.###############################.....................#
#.....#..#...............#...............................=.....................#
#.@...#..#...............#################################.....................#
#.....#..#...............#                               #.....................#
#.....#..#...............#                               #.....................#
#.....#..#...............#                               #.....................#
#.....#..#...............#                               #.....................#
#.....#..#...............#                               #.....................#
#.....#..#...............#                               #.....................#
#.....#..#...............#                               #.....................#
#.....#..#...............#                               #.....................#
#.....=..#...............#                               #.....................#
#.....##.#...............#                               #.....................#
#.....##.=...............#                               #.....................#
#.....####...............#                               #.....................#
#.....#  #...............#                               #.....................#
#.....#  #...............#                               #.....................#
#.....#  #...............#                               #.....................#
#.....#  #...............#                               #.....................#
#.....#  #...............#                               #@....................#
#######  #################                               #######################
</map>

</engine_level_t>
